1111111111111111111111111111111111
1E00000M000C00000001M10CCCCCCC0001
11100101001000M0101100000000010101
1010010010101010001001000000010101
1P00000000000000M00000000CC0000001
1111111111111111111111111111111111