111111111111111111111111111111111111111
10CC00000000CC000000CC0M0CC0100000CC111
11000011M000CC1000M0000001000000M00CC01
1P00001111M0CC1000111000C00000011100001
111100111111111000000011110011111111001
100000C0C0C0C0C0000000000000000000000E1
111110111111111001111110M000M0001111111
10M0100000CCC000000011111111000000CCC01
111111111111111111111111111111111111111