111111111111111111111111111111111111111
1000C000M0C0000000M0C00000000M0000000M1
101111011111110111111110111101110111011
10C00M000001C00000000000M0C0000000M00C1
101111111101111111111011111111111111111
10000000000M000000C010000M00000C00M00C1
111111011111011011111011111111011111011
10000001100000M000000000000000000001001
10M1110111111010111110111111011111M0001
10C01100000M0C1000M00001000C10000000101
111111111011111011101111101111111101111
10000000000000100C10000C000M00C00000001
111111111101111111101111111111111011111
1000000000000000CM100000000C00000000001
101111111011111111101111111111011111111
10P0MC00001C000M00000M00C00000000M000C1
101111101111101111111111111101111111101
10000000000000000000C000000000M00000001
101111111111111011111011111111111011111
10C000000M00C00000M00000C0000000000E0C1
111111111111111111111111111111111111111